GGGGGGGGGGGG
GUUUUUUUUGGG
GUSSSSSSUGGG
GUSSSSSSUGGG
GUSSSSSSUGGG
GUSSSSSSUGGG
GUSSSSSSUGGG
GUSSSSSSUGGG
GUUUUUUUUGGG
GGGGGGGGGGGG